%%%%%%%%%
%%%    S%
%%% %%% %
%      G%
%%%%%%%%%