%%%%%%%%%
%%%   %%%
%%% % %%%
%%%    S%
%%%%%%% %
%G      %
%%%%%%%%%