%%%%%%%
% % % %
% % % %
% % % %
%%% %%%
%     %
% %%%G%
% % %P%
% % % %
%G%%% %
%  .  %
%%% %%%
%%%%%%%
