%%%%%%%%%%%%%%
%    S       %
%   %%%%     %
%   %G  %    %
%   %   %%   %
%   %     %  %
%   %%    %  %
%            %
%%%%%%%%%%%%%%