%%%%%%%
%%%   %
%%% % %
%%%   %
%%%%% %
%G   S%
%%%%%%%