%%%%%%%%%%%%%%
%    S       %
%   %%%  G   %
%   %   %    %
%       %    %
%         %  %
%         %  %
%            %
%%%%%%%%%%%%%%